//MAP CONVERTED BY dmm2tgm.py THIS HEADER COMMENT PREVENTS RECONVERSION, DO NOT REMOVE
"a" = (
/obj/effect/turf_decal/tile/blue/opposingcorners{
	dir = 1
	},
/obj/effect/turf_decal/tile/white/opposingcorners,
/obj/structure/mirror{
	pixel_x = 28
	},
/obj/structure/sink{
	dir = 4;
	pixel_x = 11
	},
/turf/open/floor/holofloor,
/area/template_noop)
"d" = (
/obj/item/pool/rubber_ring,
/turf/open/indestructible/sound/pool,
/area/template_noop)
"f" = (
/obj/structure/closet{
	name = "swimming closet"
	},
/obj/effect/turf_decal/tile/blue/opposingcorners{
	dir = 1
	},
/obj/effect/turf_decal/tile/white/opposingcorners,
/obj/item/pool/rubber_ring,
/obj/item/pool/pool_noodle,
/obj/item/pool/pool_noodle,
/turf/open/floor/holofloor,
/area/template_noop)
"h" = (
/obj/structure/pool_ladder,
/turf/open/indestructible/sound/pool/end,
/area/template_noop)
"k" = (
/obj/effect/turf_decal/pool{
	dir = 1
	},
/obj/effect/turf_decal/pool{
	dir = 1
	},
/obj/effect/turf_decal/tile/white{
	dir = 1
	},
/turf/open/floor/holofloor,
/area/template_noop)
"l" = (
/obj/effect/turf_decal/tile/blue/opposingcorners{
	dir = 1
	},
/obj/effect/turf_decal/tile/white/opposingcorners,
/obj/item/soap/nanotrasen,
/turf/open/floor/holofloor,
/area/template_noop)
"m" = (
/obj/effect/turf_decal/pool{
	dir = 1
	},
/obj/effect/turf_decal/tile/white{
	dir = 1
	},
/turf/open/floor/holofloor,
/area/template_noop)
"n" = (
/obj/effect/turf_decal/pool{
	dir = 4
	},
/obj/structure/railing{
	dir = 4
	},
/obj/effect/turf_decal/tile/white,
/turf/open/floor/holofloor,
/area/template_noop)
"o" = (
/obj/effect/turf_decal/pool/corner{
	dir = 1
	},
/obj/structure/railing/corner{
	dir = 4
	},
/turf/open/floor/holofloor,
/area/template_noop)
"p" = (
/turf/closed/wall,
/area/template_noop)
"r" = (
/turf/open/indestructible/sound/pool,
/area/template_noop)
"s" = (
/obj/effect/turf_decal/pool/corner{
	dir = 8
	},
/obj/structure/railing/corner{
	dir = 1
	},
/obj/effect/turf_decal/tile/white{
	dir = 1
	},
/turf/open/floor/holofloor,
/area/template_noop)
"t" = (
/obj/machinery/shower{
	pixel_y = 12
	},
/obj/effect/turf_decal/tile/blue/opposingcorners{
	dir = 1
	},
/obj/effect/turf_decal/tile/white/opposingcorners,
/obj/effect/turf_decal/techfloor{
	dir = 1
	},
/obj/item/bikehorn/rubberducky,
/turf/open/floor/holofloor,
/area/template_noop)
"v" = (
/obj/effect/turf_decal/pool/corner{
	dir = 4
	},
/obj/structure/railing/corner{
	dir = 8
	},
/turf/open/floor/holofloor,
/area/template_noop)
"x" = (
/obj/machinery/door/airlock{
	name = "Unisex Showers"
	},
/obj/effect/turf_decal/tile/blue/opposingcorners{
	dir = 1
	},
/obj/effect/turf_decal/tile/white/opposingcorners,
/obj/effect/turf_decal/techfloor,
/turf/open/floor/holofloor,
/area/template_noop)
"B" = (
/obj/machinery/shower{
	pixel_y = 12
	},
/obj/effect/turf_decal/tile/blue/opposingcorners{
	dir = 1
	},
/obj/effect/turf_decal/tile/white/opposingcorners,
/obj/effect/turf_decal/techfloor{
	dir = 1
	},
/turf/open/floor/holofloor,
/area/template_noop)
"C" = (
/obj/effect/turf_decal/tile/blue/opposingcorners{
	dir = 1
	},
/obj/effect/turf_decal/tile/white/opposingcorners,
/obj/structure/mirror{
	pixel_x = -28
	},
/obj/structure/sink{
	dir = 8;
	pixel_x = -12;
	pixel_y = 2
	},
/turf/open/floor/holofloor,
/area/template_noop)
"F" = (
/turf/open/indestructible/sound/pool/end,
/area/template_noop)
"J" = (
/obj/effect/turf_decal/pool{
	dir = 8
	},
/obj/effect/turf_decal/pool{
	dir = 8
	},
/obj/structure/railing{
	dir = 8
	},
/obj/effect/turf_decal/tile/white{
	dir = 1
	},
/turf/open/floor/holofloor,
/area/template_noop)
"K" = (
/obj/effect/spawner/structure/window/reinforced/tinted,
/turf/open/floor/plating,
/area/template_noop)
"M" = (
/obj/machinery/pool_filter,
/turf/open/indestructible/sound/pool/end,
/area/template_noop)
"O" = (
/obj/effect/turf_decal/pool{
	dir = 4
	},
/obj/effect/turf_decal/pool{
	dir = 4
	},
/obj/structure/railing{
	dir = 4
	},
/obj/effect/turf_decal/tile/white,
/turf/open/floor/holofloor,
/area/template_noop)
"P" = (
/obj/structure/closet{
	name = "swimming closet"
	},
/obj/effect/turf_decal/tile/blue/opposingcorners{
	dir = 1
	},
/obj/effect/turf_decal/tile/white/opposingcorners,
/obj/item/pool/rubber_ring,
/obj/item/pool/pool_noodle,
/obj/item/pool/pool_noodle,
/obj/effect/turf_decal/techfloor{
	dir = 1
	},
/turf/open/floor/holofloor,
/area/template_noop)
"Q" = (
/obj/effect/turf_decal/tile/blue/opposingcorners{
	dir = 1
	},
/obj/effect/turf_decal/tile/white/opposingcorners,
/turf/open/floor/holofloor,
/area/template_noop)
"T" = (
/obj/effect/turf_decal/pool{
	dir = 8
	},
/obj/structure/railing{
	dir = 8
	},
/obj/effect/turf_decal/tile/white{
	dir = 1
	},
/turf/open/floor/holofloor,
/area/template_noop)
"U" = (
/obj/effect/turf_decal/tile/blue/opposingcorners{
	dir = 1
	},
/obj/effect/turf_decal/tile/white/opposingcorners,
/obj/effect/turf_decal/techfloor{
	dir = 1
	},
/obj/machinery/shower{
	pixel_y = 12
	},
/turf/open/floor/holofloor,
/area/template_noop)
"W" = (
/obj/effect/turf_decal/pool,
/obj/effect/turf_decal/tile/white,
/turf/open/floor/holofloor,
/area/template_noop)
"X" = (
/obj/effect/turf_decal/pool/corner,
/obj/structure/railing/corner,
/obj/effect/turf_decal/tile/white,
/turf/open/floor/holofloor,
/area/template_noop)

(1,1,1) = {"
B
C
K
X
O
n
n
n
n
o
"}
(2,1,1) = {"
B
l
K
W
M
r
r
r
r
m
"}
(3,1,1) = {"
U
Q
x
W
F
r
r
r
r
k
"}
(4,1,1) = {"
P
f
p
W
F
r
r
r
r
k
"}
(5,1,1) = {"
p
p
p
W
h
d
r
r
r
m
"}
(6,1,1) = {"
P
f
p
W
F
r
r
r
r
m
"}
(7,1,1) = {"
U
Q
x
W
F
r
r
r
r
k
"}
(8,1,1) = {"
t
Q
K
W
F
r
r
r
r
k
"}
(9,1,1) = {"
B
a
K
v
J
T
T
T
T
s
"}
